"","geography","weekEnding","expectedDeaths","allDeaths","excessDeaths","excessDeathsLo","excessDeathsHi","cv19Deaths"
"1","United States","2020-01-04",64663,60158,-4505,0,0,0
"2","United States","2020-01-11",64884,60735,-4149,0,0,1
"3","United States","2020-01-18",64582,59362,-5220,0,0,2
"4","United States","2020-01-25",63924,59172,-4752,0,0,2
"5","United States","2020-02-01",62516,58844,-3672,0,0,0
"6","United States","2020-02-08",62320,59482,-2838,0,0,2
"7","United States","2020-02-15",61363,58815,-2548,0,0,3
"8","United States","2020-02-22",60759,58921,-1838,0,0,6
"9","United States","2020-02-29",59995,59343,-652,0,0,9
"10","United States","2020-03-07",59807,59716,-91,0,0,38
"11","United States","2020-03-14",59418,58673,-745,0,0,60
"12","United States","2020-03-21",58731,59242,511,0,511,588
"13","United States","2020-03-28",58198,63026,4828,2865,4828,3215
"14","United States","2020-04-04",57660,72312,14652,12805,14652,10126
"15","United States","2020-04-11",57099,79096,21997,20189,21997,16317
"16","United States","2020-04-18",56624,76827,20203,18336,20203,17197
"17","United States","2020-04-25",55856,73914,18058,16268,18058,15551
"18","United States","2020-05-02",55037,69303,14266,12406,14266,13213
"19","United States","2020-05-09",54498,66814,12316,10549,12316,11233
"20","United States","2020-05-16",53976,64491,10515,8767,10515,9231
"21","United States","2020-05-23",53636,61643,8007,6237,8007,7247
"22","United States","2020-05-30",53287,59682,6395,4707,6395,6170
"23","United States","2020-06-06",53194,58908,5714,3936,5714,5056
"24","United States","2020-06-13",53049,58034,4985,3266,4985,4229
"25","United States","2020-06-20",52933,58011,5078,3336,5078,3849
"26","United States","2020-06-27",52904,58522,5618,3871,5618,3841
"27","United States","2020-07-04",52617,59825,7208,5532,7208,4547
"28","United States","2020-07-11",52357,61945,9588,7827,9588,5785
"29","United States","2020-07-18",52161,63194,11033,9328,11033,7195
"30","United States","2020-07-25",51833,64266,12433,10798,12433,8244
"31","United States","2020-08-01",51911,64235,12324,10557,12324,8302
"32","United States","2020-08-08",51879,63740,11861,10173,11861,7864
"33","United States","2020-08-15",51752,63644,11892,10104,11892,7259
"34","United States","2020-08-22",51845,62562,10717,8957,10717,6381
"35","United States","2020-08-29",51913,61125,9212,7425,9212,5747
"36","United States","2020-09-05",52093,60247,8154,6485,8154,5018
"37","United States","2020-09-12",52440,59678,7238,5490,7238,4625
"38","United States","2020-09-19",52658,59751,7093,5364,7093,4276
"39","United States","2020-09-26",52971,60613,7642,5871,7642,4299
"40","United States","2020-10-03",53346,59802,6456,4568,6456,4242
"41","United States","2020-10-10",53485,61799,8314,6514,8314,4818
"42","United States","2020-10-17",54123,60643,6520,4613,6520,5199
"43","United States","2020-10-24",54385,62209,7824,5965,7824,5996
"44","United States","2020-10-31",54559,63425,8866,7096,8866,7023
"45","United States","2020-11-07",54885,67612,12727,10862,12727,8759
"46","United States","2020-11-14",54984,68823,13839,11922,13839,10649
"47","United States","2020-11-21",55059,71677,16618,14759,16618,13358
"48","United States","2020-11-28",55316,73305,17989,16091,17989,15622
"49","United States","2020-12-05",55707,77429,21722,19858,21722,18562
"50","United States","2020-12-12",56250,82006,25756,23854,25756,20922
"51","United States","2020-12-19",56767,82957,26190,24436,26190,22327
"52","United States","2020-12-26",57631,84371,26740,24877,26740,23372
"53","United States","2021-01-02",58337,87010,28673,26775,28673,24856
"54","United States","2021-01-09",58915,87001,28086,26311,28086,25965
"55","United States","2021-01-16",59440,87335,27895,26004,27895,25684
"56","United States","2021-01-23",59573,83573,24000,22132,24000,23653
"57","United States","2021-01-30",59586,79121,19535,17733,19535,20286
"58","United States","2021-02-06",59632,76434,16802,15012,16802,16983
"59","United States","2021-02-13",59443,71463,12020,10168,12020,13483
"60","United States","2021-02-20",58506,69459,10953,8972,10953,10799
"61","United States","2021-02-27",58185,66667,8482,6471,8482,8633
"62","United States","2021-03-06",57621,63619,5998,4026,5998,6700
"63","United States","2021-03-13",57384,61788,4404,2692,4404,5694
"64","United States","2021-03-20",57039,60250,3211,1441,3211,4879
"65","United States","2021-03-27",56468,60694,4226,2286,4226,4435
"66","United States","2021-04-03",56227,58557,2330,412,2330,4175
"67","United States","2021-04-10",55679,60870,5191,3207,5191,4288
"68","United States","2021-04-17",55466,59002,3536,1801,3536,4429
"69","United States","2021-04-24",55012,60133,5121,3371,5121,4562
"70","United States","2021-05-01",54241,59665,5424,3530,5424,4144
"71","United States","2021-05-08",53984,59149,5165,3308,5165,3972
"72","United States","2021-05-15",53679,58613,4934,3173,4934,3660
"73","United States","2021-05-22",53355,58870,5515,3836,5515,3211
"74","United States","2021-05-29",53098,57381,4283,2590,4283,2752
"75","United States","2021-06-05",52652,57128,4476,2616,4476,2331
"76","United States","2021-06-12",52753,56806,4053,2213,4053,2020
"77","United States","2021-06-19",52784,56899,4115,2342,4115,1756
"78","United States","2021-06-26",52736,56665,3929,2262,3929,1611
"79","United States","2021-07-03",52506,56902,4396,2700,4396,1513
"80","United States","2021-07-10",52192,56391,4199,2430,4199,1615
"81","United States","2021-07-17",52007,56433,4426,2625,4426,1953
"82","United States","2021-07-24",51993,57654,5661,3907,5661,2728
"83","United States","2021-07-31",51901,59481,7580,5866,7580,4030
"84","United States","2021-08-07",51748,62466,10718,9036,10718,6325
"85","United States","2021-08-14",51490,65822,14332,12538,14332,9141
"86","United States","2021-08-21",51707,68668,16961,15113,16961,11819
"87","United States","2021-08-28",51665,70650,18985,17090,18985,13696
"88","United States","2021-09-04",52043,71816,19773,18051,19773,14813
"89","United States","2021-09-11",52420,71833,19413,17575,19413,14559
"90","United States","2021-09-18",52566,71095,18529,16561,18529,14196
"91","United States","2021-09-25",52972,68612,15640,13663,15640,12879
"92","United States","2021-10-02",53494,65447,11953,10046,11953,10622
"93","United States","2021-10-09",54047,58973,4926,3095,4926,7942
"94","United States","2021-10-16",54439,49604,-4835,0,0,4874
